0,0,0,0,0,0,0,0,0,0,0,0,0,0,0,0,0,0,0,0,0,0,0,0,0,0,0,0,0,0,0,0
0,84,79,84,65,76,0,0,95,95,95,0,84,73,77,69,0,0,95,95,95,0,0,0,0,0,0,0,0,0,0,0
0,67,76,73,69,78,84,0,95,95,95,0,84,79,84,65,76,0,95,95,95,0,83,67,79,82,69,0,95,95,95,0
0,0,0,0,0,0,0,0,0,0,0,0,0,0,0,0,0,0,0,0,0,0,0,0,0,0,0,0,0,0,0,0
0,213,214,214,214,214,214,215,0,0,0,0,250,0,0,0,0,0,0,0,0,0,0,0,0,0,0,0,0,0,0,0
0,229,0,0,0,0,0,231,0,217,235,202,0,236,0,0,0,0,0,0,0,0,0,0,0,0,0,0,0,0,0,0
0,229,0,0,0,0,0,231,0,216,187,188,189,185,0,0,0,0,0,0,0,0,0,0,0,0,0,0,0,0,0,0
0,229,0,0,0,0,0,231,0,216,203,204,205,0,236,0,0,0,0,0,0,0,0,0,0,0,0,0,0,0,0,0
0,245,246,246,246,246,246,247,0,232,219,220,221,253,254,0,0,0,0,0,0,0,0,0,0,0,0,0,0,0,0,0
0,0,0,158,159,0,0,0,0,248,249,250,233,235,0,0,0,0,0,0,0,0,0,0,0,0,0,0,0,0,0,0
0,0,0,174,175,0,0,0,0,211,0,0,0,0,0,0,0,0,0,0,0,0,0,0,0,0,0,0,0,0,0,0
0,0,0,190,191,0,0,0,211,0,0,0,0,0,0,0,0,0,0,0,0,0,0,0,0,0,0,0,0,0,0,0
0,0,0,206,207,0,0,211,0,0,0,0,0,0,0,0,0,0,0,0,0,0,0,0,0,0,0,0,0,0,0,0
0,0,0,0,0,128,129,138,139,140,141,0,0,0,0,213,214,214,215,213,214,214,215,213,214,214,215,213,214,214,215,0
0,0,0,0,0,144,145,154,155,156,157,0,0,0,0,229,0,0,231,229,0,0,231,229,0,0,231,229,0,0,231,0
0,0,0,0,0,160,161,170,171,172,173,0,0,0,0,229,0,0,231,229,0,0,231,229,0,0,231,229,0,0,231,0
0,0,0,206,0,0,0,0,206,0,0,0,0,0,0,229,0,0,231,229,0,0,231,229,0,0,231,229,0,0,231,0
0,0,0,0,0,0,0,0,0,0,206,0,0,0,0,229,0,0,231,229,0,0,231,229,0,0,231,229,0,0,231,0
0,0,0,0,0,0,0,0,0,0,0,206,0,0,0,245,246,246,247,245,246,246,247,245,246,246,247,245,246,246,247,0
0,0,0,0,0,0,0,0,0,0,0,0,0,0,0,0,0,0,0,0,0,0,0,0,0,0,0,0,0,0,0,0
0,0,0,0,0,0,213,214,214,215,0,0,0,0,0,208,209,209,210,208,209,209,210,208,209,209,210,208,209,209,210,0
0,0,0,0,0,0,229,0,0,231,0,0,0,0,0,224,225,225,226,224,225,225,226,224,225,225,226,224,225,225,226,0
0,0,0,0,0,0,229,0,0,231,0,0,0,0,0,224,225,225,226,224,225,225,226,224,225,225,226,224,225,225,226,0
0,0,0,0,0,0,229,0,0,231,0,0,0,0,0,224,225,225,226,224,225,225,226,224,225,225,226,224,225,225,226,0
0,0,0,0,0,0,229,0,0,231,0,0,0,0,0,224,225,225,226,224,225,225,226,224,225,225,226,224,225,225,226,0
0,0,0,0,0,0,245,246,246,247,0,0,0,0,0,240,241,241,242,240,241,241,242,240,241,241,242,240,241,241,242,0
0,0,0,0,0,0,0,0,0,0,0,0,0,0,0,0,0,0,0,0,0,0,0,0,0,0,0,0,0,0,0,0
0,0,0,0,0,0,0,0,0,0,0,0,0,0,0,0,0,0,0,0,0,0,0,0,0,0,0,0,0,0,0,0
0,0,0,0,0,0,0,0,0,0,0,0,0,0,0,0,0,0,0,0,0,0,0,0,0,0,0,0,0,0,0,0
0,0,0,0,0,0,0,0,0,0,0,0,0,0,0,0,0,0,0,0,0,0,0,0,0,0,0,0,0,0,0,0
